1111111111
1000000001
1000000001
1000000001
1222220001
1111111111