11111111111111111111111111111111
10000000000000000000000000000001
10000000000000000000000000000001
10000000000000022200000000000001
10000000000000000000000000000001
10000000000000000000000000000001
10000000000000000000000000000001
10000000000000000000000000000001
10000000222200000002000000000001
10000000000000000002000000000001
10000000000000000002200220000001
12200000000000000000000000000001
10000000000000000000000000002221
10000000000000000000000000000001
10000000000000020000000000000001
10000000222222222222222000000001
10000000000000000000000000000001
10000000000000000000000000002221
10000000000000000000000000000001
12222200000000000000000000000001
10000000000000000000022200000001
10000000000002000000000000000001
10000000000022000000000000000001
11111111111111111111111111111111